name: level_1
size: 36
design:
{
0, 0, 0, 1, 1, 0,
0, 0, 0, 1, 1, 0,
0, 1, 0, 1, 1, 0,
1, 1, 0, 0, 0, 0,
0, 0, 0, 1, 1, 0,
0, 0, 0, 0, 1, 0,

}

name: level_2
size: 36
design:
{
0, 0, 0, 0, 0, 0,
0, 0, 0, 0, 0, 0,
0, 0, 0, 0, 0, 0,
0, 0, 0, 0, 0, 0,
0, 0, 0, 0, 0, 0,
0, 0, 0, 0, 0, 0,

}